208
11
0 1 2 3 4 5 0 6 0 1 2 3 4 5 0 6 0 1 2 7 8 9 0 6 0 1 2 10 4 5 0 11 12 13 2 3 4 14 12 15 0 6 0 6 0 6 0 1 2 16 17 18 19 20 2 21 22 23 0 6 0 11 12 13 2 24 12 13 2 24 12 13 2 24 12 13 2 25 0 11 26 27 0 28 29 30 22 23 0 31 32 33 2 34 35 36 37 38 38 38 38 39 40 41 38 38 38 38 38 38 38 42 43 44 38 42 43 45 38 38 38 38 38 38 38 46 47 48 0 6 0 1 2 21 22 23 0 1 2 49 12 15 0 1 2 16 17 50 51 52 53 54 0 55 56 57 2 58 53 54 0 55 56 57 2 58 53 54 0 59 8 60 12 61 62 63 64 65 66 67 68 69 64 65 69 69 69 69 64 65 69 69 64 65 69 69 70 71 66 67 68 69 69 69 70 71 72 73
74 75 76 77 78 79 80 81 82 83 76 77 78 79 80 81 82 83 76 84 85 86 80 81 82 83 76 87 78 79 80 88 89 90 76 77 78 91 92 93 82 94 82 94 82 94 82 83 76 87 95 96 97 98 76 99 100 101 82 94 82 102 89 90 76 103 92 104 76 103 92 104 76 103 92 104 76 105 82 106 107 108 82 109 100 110 100 101 82 111 112 113 76 114 115 116 117 38 118 119 38 120 121 122 38 123 124 123 124 123 124 39 125 126 118 127 128 129 38 38 38 123 124 123 124 38 130 131 82 102 74 75 76 99 100 101 82 83 76 132 92 93 82 83 76 87 133 134 135 136 137 138 139 140 141 142 76 143 144 145 139 140 141 142 76 143 144 145 139 146 85 147 92 148 149 63 150 151 152 152 153 154 150 155 156 156 156 156 150 155 156 156 150 151 156 156 150 151 152 152 153 154 156 156 150 151 157 158
159 160 76 77 161 162 163 164 165 166 76 77 161 162 163 164 165 166 76 167 168 169 163 164 165 166 76 87 161 162 163 170 159 160 76 77 161 171 172 173 165 174 165 174 165 174 165 166 76 175 176 177 97 98 76 178 165 174 165 174 165 179 159 160 76 180 172 113 76 180 172 113 76 180 172 113 76 178 165 181 182 183 165 174 165 174 165 174 165 181 184 113 76 185 130 186 117 38 187 188 38 189 190 191 38 192 193 192 193 192 193 189 190 126 187 194 195 185 38 38 38 192 193 192 193 38 130 196 165 179 197 160 76 178 165 174 165 166 76 198 172 173 165 166 76 87 199 200 159 201 165 166 76 202 203 204 76 205 206 207 76 202 203 204 76 205 206 207 76 167 168 208 172 209 210 63 150 151 152 152 152 153 211 155 156 156 156 156 211 155 156 156 150 151 156 156 150 151 152 152 152 153 154 156 150 151 157 158
100 212 76 77 213 214 92 93 82 83 76 77 215 216 92 93 82 83 76 77 78 91 92 93 82 83 76 87 215 216 92 217 100 212 76 77 215 218 172 219 82 94 82 220 221 222 223 224 225 226 227 228 229 230 231 232 233 234 235 236 82 109 100 212 76 180 172 113 76 180 172 113 76 180 172 113 76 237 80 238 182 239 82 220 221 222 223 240 241 242 243 244 225 245 130 246 117 38 38 38 38 247 248 249 38 38 38 250 251 252 251 253 128 254 251 255 195 185 38 38 118 119 38 38 38 38 130 256 257 258 259 260 231 232 233 234 235 261 76 198 172 219 82 83 76 87 262 263 100 101 82 83 76 264 265 266 76 205 137 267 76 264 265 266 76 268 269 270 76 77 271 272 172 273 115 116 150 155 152 152 152 152 274 274 156 156 156 156 150 155 156 156 150 151 156 156 150 151 152 152 152 152 153 154 150 151 157 158
165 166 76 275 276 177 172 173 165 166 76 77 161 171 172 173 165 166 76 77 161 171 172 173 165 166 76 87 161 171 172 173 165 166 76 77 161 171 172 173 165 174 165 277 278 279 280 281 282 283 284 285 286 286 286 286 287 288 289 290 165 174 165 166 76 180 172 113 76 180 172 113 76 180 172 113 76 291 292 293 97 294 165 277 278 279 280 286 286 295 284 296 282 297 286 298 286 286 286 286 286 281 282 299 38 38 38 130 300 301 300 302 195 303 300 302 195 185 38 38 187 304 286 286 286 286 286 305 284 285 286 286 286 286 287 288 289 306 76 198 172 173 165 166 76 175 176 307 165 174 165 166 76 308 165 166 76 308 165 166 76 308 165 166 76 309 163 310 76 275 276 177 172 311 130 312 211 155 152 152 152 152 313 314 156 156 156 156 211 155 156 156 150 151 156 156 150 151 152 152 152 152 152 153 150 151 157 158
82 83 76 315 316 317 172 219 82 83 76 77 213 318 172 319 80 320 76 77 215 218 172 219 82 83 76 87 213 318 172 219 82 83 76 77 215 218 172 321 221 222 223 322 323 324 325 326 40 327 328 329 330 331 40 332 333 334 335 336 337 338 241 339 76 180 172 113 76 180 172 113 76 180 172 113 76 340 341 342 343 344 221 345 346 324 325 347 328 348 328 349 350 351 352 353 37 250 251 252 251 253 40 354 38 355 356 357 38 250 251 358 359 360 361 362 363 364 38 355 356 357 38 38 118 127 365 366 367 368 328 369 370 371 333 334 335 372 231 373 243 374 241 375 231 376 377 378 235 236 82 83 76 205 82 83 76 205 82 83 76 205 82 83 76 379 89 90 76 380 381 382 383 384 130 246 274 274 274 274 274 274 274 274 274 274 274 274 274 274 156 156 274 274 156 156 274 274 274 274 274 274 274 274 274 385 157 158
165 166 76 308 165 386 172 173 165 166 76 275 276 177 172 387 163 310 76 77 161 171 172 173 165 166 76 388 276 177 172 173 165 166 76 77 161 171 172 389 278 279 280 390 391 392 393 394 195 178 165 179 395 396 195 397 398 399 400 401 402 403 404 405 76 180 172 113 76 180 172 113 76 180 172 113 76 406 407 408 409 410 278 279 411 412 413 414 165 174 165 415 195 416 417 353 37 130 300 301 300 302 195 418 286 286 287 419 420 421 300 422 423 423 423 424 350 425 286 286 287 419 420 426 187 194 427 428 429 430 165 166 76 431 398 432 433 286 286 295 284 285 286 286 286 286 287 288 289 290 165 166 76 308 165 166 76 308 165 166 76 308 165 166 76 434 159 160 76 435 278 279 280 286 286 436 313 314 437 438 437 438 313 314 439 440 437 438 313 314 156 156 313 314 156 156 313 314 437 438 437 438 437 438 313 65 157 158
82 83 76 205 82 111 172 319 80 320 76 315 316 317 172 441 89 90 76 77 213 318 172 219 82 83 76 442 316 317 172 441 74 75 76 77 213 443 444 445 346 324 325 446 447 448 449 450 195 105 82 109 100 451 195 99 265 452 453 454 455 456 457 458 76 180 172 113 76 180 172 113 76 180 172 113 76 459 460 461 462 463 346 324 464 465 466 467 82 94 82 468 195 469 149 353 37 38 38 38 38 120 121 470 251 253 40 471 472 473 38 474 361 423 361 475 121 470 251 253 40 471 472 473 38 120 427 476 95 477 82 83 76 478 265 479 447 480 40 481 330 331 40 481 330 482 333 334 335 483 235 261 76 205 82 83 76 205 82 83 76 205 82 83 76 478 100 212 76 309 323 324 325 484 352 63 150 155 156 156 156 156 150 155 485 486 487 487 150 151 156 488 150 151 156 488 150 151 487 487 156 488 156 156 150 151 274 274
165 166 76 308 165 386 172 387 163 310 76 308 165 386 172 489 159 160 76 275 276 177 172 173 165 166 76 178 165 386 172 489 159 160 76 275 276 490 278 279 411 491 492 493 163 164 165 415 195 178 165 174 165 415 195 178 165 166 76 309 163 494 163 310 76 180 172 113 76 180 172 113 76 180 172 113 76 291 495 496 278 279 411 412 413 493 292 497 165 174 165 415 195 416 210 353 37 38 38 38 38 189 190 498 300 302 195 185 499 472 420 421 500 501 501 502 190 498 300 302 195 185 499 472 420 503 427 504 176 307 165 166 76 308 165 505 163 506 195 406 395 396 195 406 395 507 398 508 509 288 289 306 76 308 165 166 76 308 165 166 76 308 165 166 76 308 165 166 76 510 511 512 393 513 210 63 211 155 156 156 156 156 211 155 156 156 487 487 150 151 514 515 150 151 514 515 150 151 487 487 514 515 156 156 150 151 437 438
337 516 517 518 337 519 520 521 522 523 517 518 337 519 520 524 525 526 517 527 528 529 520 521 337 530 225 531 532 519 520 524 525 526 517 527 528 533 323 534 535 536 537 538 522 539 337 540 541 542 532 543 337 540 541 542 532 516 517 518 522 539 522 523 517 544 520 545 517 544 520 545 517 544 520 244 225 546 547 548 323 534 535 536 549 538 550 551 337 543 337 552 553 554 555 353 37 355 356 357 38 247 248 249 38 556 541 557 558 559 472 560 561 562 563 564 248 565 356 566 541 557 558 559 472 567 568 569 227 570 337 516 517 518 337 543 522 571 541 572 573 574 541 572 573 575 576 577 578 579 335 580 517 518 337 516 517 518 337 516 517 518 337 516 517 518 337 516 517 527 581 582 537 583 555 63 584 585 584 585 584 585 584 585 584 585 584 585 584 585 584 585 584 585 584 585 584 585 584 585 584 585 584 585 274 274 584 585
284 296 282 283 284 586 284 586 284 296 282 283 284 586 284 586 284 296 282 283 284 586 284 586 284 296 282 283 284 586 284 586 284 296 282 283 284 587 391 295 284 586 284 586 284 586 284 296 282 283 284 586 284 296 282 283 284 296 282 283 284 586 284 296 282 283 284 296 282 283 284 296 282 283 284 296 282 283 284 587 391 295 284 586 284 586 284 586 284 586 284 296 282 588 589 286 286 286 287 590 286 281 282 297 286 281 282 297 286 286 433 591 592 593 593 594 282 297 287 595 282 297 286 286 433 281 596 597 284 586 284 296 282 283 284 586 284 296 282 283 284 296 282 283 284 586 284 586 284 285 433 281 282 283 284 296 282 283 284 296 282 283 284 296 282 283 284 296 282 283 284 586 284 587 589 598 599 600 599 600 599 600 599 600 599 600 599 600 599 600 599 600 599 600 599 600 599 600 599 600 599 600 599 600 313 314 599 600